000000000100001000000000
000000011100001110000000
000000110000000011000000
000000110000000011000000
000000110000000011000000
000000110000000011100000
000000110000000011111111
111111110000000011111110
011111111111111111000000
000001111111111111000000
000000001100000111000000
000000001100000111000000
000000001100000111000000
000000001100000111111110
000000001100000111000000
000000001100000110000000
011111111100000110000000
111111111111111110000000
011111111000000111000000
000000011000000111111111
000000011000000111111110
000000011000000110000000
000000011000000110000000
000000011000000110000000
000000010000000010000000